     0           
             &   
  H        T     
  H############H 
  H  T         H 
  H  H      H  H 
  H  H## F #H##HH
  ###H      H ##H
$$$$$$$$$$$$$$$$$
#################
