     0          
                 
  H   --      &  
  H###  #######HT
  H  T         H 
  H  H      H--  
  H  H##  ##H    
  ###H      H ## 
        $     $$F
#################
